11111111111111111
100111110000E0001
10010001000000001
1001000100000C001
10010001000C00001
1001111100000P001
11111111111111111