1111111111111111
1C0C000CC000CCC1
1000C00000000001
10000000E0000001
10P0000000000001
1111111111111111